Disaster Date,Province,Affected People,Affected Households,Deaths,Injured,Housing Damage,Business Damage,Agriculture Damage,Total Damage
1/10/2023,Khon Kaen,128,33,0,0,0,0,0,161
1/10/2023,Chachoengsao,0,0,0,0,0,0,0,0
1/10/2023,dry,0,0,0,0,0,0,0,0
1/10/2023,Nakhon Pathom,792,264,0,0,0,0,0,1056
1/10/2023,Nakhon Sawan,0,0,0,0,0,0,0,0
1/10/2023,Prachin Buri,870,290,0,0,80,0,0,1240
1/10/2023,Ayutthaya,51,17,0,0,0,0,175,243
1/10/2023,Phichit,0,0,0,0,0,0,0,0
1/10/2023,Saraburi,3,1,0,0,59,0,0,63
1/10/2023,Sa Kaeo,423,155,0,0,0,0,563,1141
1/10/2023,Sukhothai,3847,1810,0,0,0,0,27081,32738
1/10/2023,Nong Bua Lamphu,3,1,0,0,0,0,2583,2587
1/10/2023,Ang Thong,3,1,0,0,0,0,8,12
1/10/2023,Chiang Mai,220,57,0,0,0,0,0,277
1/10/2023,Mae Hong Son,0,0,0,0,0,0,0,0
1/11/2023,Kamphaeng Phet,3,1,0,0,0,0,1200,1204
1/11/2023,Yala,3,1,0,0,0,0,0,4
1/11/2023,Sa Kaeo,180,60,0,0,0,0,600,840
1/11/2023,Chiang Rai,15,5,0,0,0,0,9,29
1/12/2023,Trang,0,0,0,0,0,0,0,0
1/12/2023,Narathiwat,3774,862,0,0,1131,0,0,5767
1/12/2023,Yala,6,2,0,0,9,0,0,17
1/7/2023,Trang,15,5,0,0,26,0,0,46
1/7/2023,Phangnga,42,14,0,0,133,0,0,189
1/7/2023,Satun,0,0,0,0,0,0,0,0
1/7/2023,Nong Khai,0,0,0,0,0,0,0,0
1/8/2023,Kalasin,120,40,0,0,0,0,0,160
1/8/2023,Nakhon Phanom,12279,4093,0,0,0,0,18432,34804
1/8/2023,Sakon Nakhon,1302,444,0,0,0,0,3392,5138
1/8/2023,Satun,0,0,0,0,0,0,0,0
1/8/2023,Ubon Ratchathani,2928,976,0,0,0,0,8073,11977
1/8/2023,Chiang Mai,20145,12124,0,0,0,0,20,32289
1/9/2023,Chanthaburi,1251,417,1,1,0,0,0,1670
1/9/2023,Yasothon,24,8,0,0,0,0,127197,127229
1/9/2023,Surin,30,10,0,0,0,0,0,40
1/9/2023,Ubon Ratchathani,0,0,0,0,0,0,0,0
1/9/2023,Chiang Mai,18154,6033,0,0,0,0,1174,25361
1/9/2023,spread,21,7,0,0,4,0,2,34
10/10/2023,Kanchanaburi,30,30,0,0,0,0,0,60
10/10/2023,Kamphaeng Phet,3,1,0,0,0,0,111,115
10/10/2023,Chanthaburi,1,1,0,0,0,0,30,32
10/10/2023,dry,3,1,0,0,0,0,0,4
10/10/2023,Nakhon Nayok,0,0,0,0,0,0,0,0
10/10/2023,Nakhon Ratchasima,273,91,0,0,2974,0,10036,13374
10/10/2023,Buriram,63,21,0,0,0,0,468,552
10/10/2023,Prachin Buri,3,1,0,0,48,0,0,52
10/10/2023,Phichit,0,0,0,0,0,0,0,0
10/10/2023,Roi Et,1218,406,0,0,0,0,252,1876
10/10/2023,Saraburi,24,8,0,0,40,0,4109,4181
10/10/2023,Sa Kaeo,600,200,0,0,0,0,200,1000
10/10/2023,Suphan Buri,6,2,0,0,1,0,0,9
10/10/2023,Surin,3,1,0,0,0,0,0,4
10/10/2023,Sukhothai,125,28,0,0,0,0,115,268
10/10/2023,Nong Bua Lamphu,3,1,0,0,1,0,0,5
10/10/2023,Uttaradit,1329,443,0,0,0,0,2696,4468
10/10/2023,Ang Thong,3,1,0,0,0,0,10,14
10/10/2023,Chiang Rai,150,50,0,0,0,0,0,200
10/10/2023,Mae Hong Son,0,0,0,0,0,0,0,0
10/7/2023,Kalasin,100,50,0,0,6,0,0,156
10/7/2023,Chiang Mai,3,1,0,0,0,0,0,4
10/8/2023,Sakon Nakhon,1089,363,0,0,0,0,2813,4265
10/8/2023,Nong Khai,0,0,0,0,0,0,0,0
10/9/2023,Nan,3,1,0,0,0,0,0,4
10/9/2023,Phayao,0,0,0,0,0,0,0,0
10/9/2023,Mukdahan,100,195,0,0,0,0,220,515
10/9/2023,Satun,480,160,0,0,0,0,0,640
10/9/2023,Uttaradit,585,195,0,0,11,0,240,1031
10/9/2023,Ubon Ratchathani,0,0,0,0,0,0,0,0
10/9/2023,Chiang Rai,675,225,0,0,115,0,1200,2215
10/9/2023,Chiang Mai,1375,267,0,0,0,0,31,1673
10/9/2023,Phetchabun,6,2,0,0,12,0,0,20
10/9/2023,spread,9,3,0,0,20,0,94,126
11/10/2023,Kalasin,238,116,0,0,0,0,1203,1557
11/10/2023,Kamphaeng Phet,6,2,0,0,0,0,78,86
11/10/2023,Khon Kaen,1392,464,0,0,10,0,11832,13698
11/10/2023,Chachoengsao,0,0,0,0,0,0,0,0
11/10/2023,Nakhon Ratchasima,33,11,0,0,23,0,85,152
11/10/2023,Nakhon Sawan,12,4,0,0,0,0,100,116
11/10/2023,Buriram,78,26,0,0,0,0,4861,4965
11/10/2023,Phichit,0,0,0,0,0,0,0,0
11/10/2023,Yala,108,36,0,0,36,0,0,180
11/10/2023,Nong Bua Lamphu,3,1,0,0,100,0,1400,1504
11/10/2023,Chiang Mai,3562,750,0,0,0,0,95,4407
11/11/2023,Nakhon Pathom,100,20,0,0,10,0,0,130
11/11/2023,Nakhon Si Thammarat,201,60,0,0,0,0,345,606
11/8/2023,Chiang Mai,9868,3768,0,0,0,0,5,13641
11/9/2023,Roi Et,975,390,1,0,0,0,7764,9130
11/9/2023,Surin,21,7,0,0,0,0,0,28
11/9/2023,Uttaradit,90,30,0,0,0,0,0,120
11/9/2023,Chiang Mai,2400,1044,0,0,0,0,82,3526
12/10/2023,Kalasin,4,2,0,0,0,0,25,31
12/10/2023,Khon Kaen,3,1,0,0,0,0,1100,1104
12/10/2023,Nakhon Ratchasima,102,34,0,0,1290,0,12801,14227
12/10/2023,Maha Sarakham,1056,528,0,0,0,0,4037,5621
12/10/2023,Yala,12,4,0,0,38,0,0,54
12/10/2023,Lampang,396,132,0,0,132,0,0,660
12/10/2023,Sukhothai,67,20,0,0,0,0,0,87
12/10/2023,Ubon Ratchathani,0,0,0,0,0,0,0,0
12/10/2023,Chiang Rai,18,6,0,0,0,0,48,72
12/10/2023,Chiang Mai,100,45,0,0,0,0,50,195
12/11/2023,Nakhon Si Thammarat,210,70,0,0,0,0,0,280
12/11/2023,Prachuap Khiri Khan,1000,500,0,0,10,0,0,1510
12/9/2023,Nakhon Phanom,3,1,0,0,0,0,10,14
12/9/2023,Phayao,21,7,0,0,0,0,462,490
12/9/2023,Roi Et,226,66,0,0,0,0,4065,4357
12/9/2023,Ubon Ratchathani,0,0,0,0,0,0,0,0
13/10/2023,Nakhon Ratchasima,48,16,0,0,350,0,2003,2417
13/10/2023,Nakhon Sawan,3,1,0,0,34,0,11,49
13/10/2023,Buriram,18,6,0,0,0,0,0,24
13/10/2023,Phayao,3,1,0,0,0,0,0,4
13/10/2023,Phichit,0,0,0,0,0,0,0,0
13/10/2023,Ang Thong,3,1,0,0,33,0,0,37
13/10/2023,Chiang Rai,48,16,0,0,0,0,119,183
13/10/2023,Chiang Mai,826,205,0,0,0,0,25,1056
13/11/2023,Songkhla,1500,500,0,1,1,0,0,2002
13/12/2023,Narathiwat,4031,1160,0,0,1160,0,0,6351
13/9/2023,Kalasin,42,24,0,0,0,0,154,220
13/9/2023,Phayao,0,0,0,0,0,0,0,0
13/9/2023,Roi Et,255,98,0,0,14,0,3331,3698
13/9/2023,Ubon Ratchathani,0,0,0,0,0,0,0,0
13/9/2023,Chiang Mai,140,52,0,0,0,0,0,192
14/1/2023,Songkhla,0,39,0,0,39,0,0,78
14/10/2023,Krabi,3,1,0,0,0,0,0,4
14/10/2023,Kamphaeng Phet,3,1,0,0,0,0,1068,1072
14/10/2023,Nakhon Sawan,0,0,0,0,0,0,0,0
14/10/2023,Buriram,225,75,0,0,0,0,17096,17396
14/10/2023,Lampang,4542,1514,0,0,1234,0,15,7305
14/10/2023,Nong Khai,0,0,0,0,0,0,0,0
14/10/2023,Uttaradit,84,28,0,0,0,0,70,182
14/10/2023,Chiang Mai,500,200,0,0,0,0,35,735
14/10/2023,spread,3,1,0,0,65,0,6,75
14/11/2023,Chumphon,58,16,0,0,16,0,0,90
14/11/2023,Nakhon Pathom,110,45,0,0,33,0,0,188
14/12/2023,Narathiwat,39902,9523,7,0,1683,0,0,51115
14/12/2023,Yala,3,1,0,0,10,0,0,14
14/5/2023,Chiang Mai,0,50,0,0,0,0,216,266
14/8/2023,Kalasin,9,3,0,0,0,0,0,12
14/8/2023,Trang,0,0,0,0,0,0,0,0
14/8/2023,Satun,9,3,0,0,30,0,0,42
14/8/2023,Surat Thani,0,0,0,0,0,0,0,0
14/9/2023,Kalasin,300,90,0,0,0,0,0,390
14/9/2023,Phayao,0,0,0,0,0,0,0,0
14/9/2023,Phichit,0,0,0,0,0,0,0,0
14/9/2023,Roi Et,502,142,0,0,37,0,1259,1940
14/9/2023,Sakon Nakhon,6012,2004,0,0,125,0,13256,21397
14/9/2023,Nong Bua Lamphu,3,1,0,0,1,0,400,405
14/9/2023,Uttaradit,1830,610,0,0,0,0,7521,9961
14/9/2023,Mae Hong Son,0,0,0,0,0,0,0,0
15/10/2023,Kanchanaburi,36,12,0,0,0,0,60,108
15/10/2023,Kamphaeng Phet,3,1,0,0,0,0,117,121
15/10/2023,Chaiyaphum,0,0,0,0,0,0,0,0
15/10/2023,dry,0,0,0,0,0,0,0,0
15/10/2023,Nakhon Ratchasima,39,13,0,0,137,0,3286,3475
15/10/2023,Nakhon Si Thammarat,3,1,0,0,15,0,0,19
15/10/2023,Nakhon Sawan,0,0,0,0,0,0,0,0
15/10/2023,Phayao,18,7,4,0,8,0,125,162
15/10/2023,Lampang,3942,1314,0,0,0,0,22,5278
15/10/2023,Lamphun,0,0,0,0,0,0,0,0
15/10/2023,Chiang Mai,11633,3843,0,0,0,0,24,15500
15/11/2023,Nakhon Pathom,45,19,0,0,16,0,0,80
15/11/2023,Nakhon Si Thammarat,500,330,0,0,0,0,0,830
15/11/2023,Songkhla,1923,641,0,0,13,0,0,2577
15/8/2023,Trang,0,0,0,0,0,0,0,0
15/8/2023,Nakhon Phanom,24,8,0,0,0,0,29,61
15/8/2023,Satun,255,85,0,0,85,0,0,425
15/8/2023,Chiang Rai,90,30,0,0,0,0,0,120
15/8/2023,Chiang Mai,50,22,0,0,0,0,30,102
15/9/2023,Kalasin,282,91,0,0,0,0,173,546
15/9/2023,Kamphaeng Phet,9,3,0,0,5,0,1890,1907
15/9/2023,Khon Kaen,0,0,0,0,0,0,0,0
15/9/2023,Chanthaburi,291,97,0,0,0,0,1000,1388
15/9/2023,Chaiyaphum,0,0,0,0,0,0,0,0
15/9/2023,Trat,453,166,0,0,0,0,0,619
15/9/2023,Nakhon Phanom,1800,600,0,0,0,0,864,3264
15/9/2023,Nan,0,0,0,0,0,0,0,0
15/9/2023,Phichit,0,0,0,0,0,0,0,0
15/9/2023,Mukdahan,383,40,0,0,0,0,415,838
15/9/2023,Yasothon,3,1,0,0,0,0,2389,2393
15/9/2023,Roi Et,1857,728,0,0,3,0,301,2889
15/9/2023,Sakon Nakhon,5094,1548,0,0,1,2,10555,17200
15/9/2023,Nong Khai,0,0,0,0,0,0,0,0
15/9/2023,Nong Bua Lamphu,3,1,0,0,0,0,342,346
15/9/2023,Udon Thani,0,0,0,0,0,0,0,0
15/9/2023,Ubon Ratchathani,0,0,0,0,0,0,0,0
15/9/2023,Chiang Rai,45,15,0,0,0,0,40,100
15/9/2023,Chiang Mai,7212,2120,0,0,0,0,799,10131
15/9/2023,Phetchabun,42,14,1,0,235,0,563,855
15/9/2023,at all,3973,1197,0,0,713,0,3769,9652
16/10/2023,Kanchanaburi,58,21,0,0,11,0,55,145
16/10/2023,Kamphaeng Phet,6,2,0,0,5,0,6500,6513
16/10/2023,Nakhon Ratchasima,60,20,0,0,364,0,2199,2643
16/10/2023,Nakhon Sawan,0,0,0,0,0,0,0,0
16/10/2023,Buriram,21,7,0,0,0,0,530,558
16/10/2023,Phichit,0,0,0,0,0,0,0,0
16/10/2023,Lampang,513,171,0,0,141,0,244,1069
16/10/2023,Surin,3,1,0,0,0,0,150,154
16/10/2023,Sukhothai,361,152,0,0,0,0,1860,2373
16/10/2023,Chiang Rai,300,100,0,0,0,0,315,715
16/10/2023,Chiang Mai,658,126,0,0,2,0,8,794
16/11/2023,Nakhon Si Thammarat,4592,1554,0,0,0,0,250,6396
16/11/2023,Phatthalung,3,1,0,0,40,0,250,294
16/11/2023,Ranong,1886,603,0,0,603,0,0,3092
16/11/2023,Songkhla,4200,1400,0,0,25,0,0,5625
16/7/2023,Ranong,255,72,0,0,72,0,0,399
16/7/2023,Chiang Rai,3,1,0,0,0,0,0,4
16/8/2023,Chiang Rai,33,11,0,0,0,0,28,72
16/9/2023,Kalasin,205,205,0,0,0,0,1688,2098
16/9/2023,Chaiyaphum,0,0,0,0,0,0,0,0
16/9/2023,Mukdahan,6,2,0,0,0,0,110,118
16/9/2023,Roi Et,28,7,0,0,1,0,0,36
16/9/2023,Lamphun,0,0,0,0,0,0,0,0
16/9/2023,Saraburi,3,1,0,0,191,0,20,215
16/9/2023,Nong Khai,0,0,0,0,0,0,0,0
16/9/2023,Nong Bua Lamphu,0,0,0,0,0,0,0,0
16/9/2023,Amnat Charoen,0,0,0,0,0,0,0,0
16/9/2023,Udon Thani,0,0,0,0,0,0,0,0
16/9/2023,Ubon Ratchathani,0,0,0,0,0,0,0,0
16/9/2023,Chiang Rai,255,85,0,0,0,0,70,410
16/9/2023,Chiang Mai,12763,3605,0,0,0,0,640,17008
16/9/2023,Phetchabun,12,4,0,0,31,0,0,47
17/10/2023,Nakhon Si Thammarat,3,1,0,0,15,0,0,19
17/10/2023,Nakhon Sawan,0,0,0,0,0,0,0,0
17/10/2023,Buriram,6,2,0,0,0,0,236,244
17/10/2023,Surin,48,16,0,0,0,0,0,64
17/10/2023,Sukhothai,24,8,0,0,0,0,0,32
17/11/2023,Kanchanaburi,6,2,0,0,0,0,20,28
17/11/2023,Chumphon,18640,5911,0,0,222,1,1390,26164
17/11/2023,Nakhon Si Thammarat,0,0,0,0,0,0,0,0
17/11/2023,Phatthalung,12,4,0,0,686,0,0,702
17/11/2023,Songkhla,0,0,0,0,0,0,0,0
17/5/2023,Chanthaburi,120,40,0,0,6,0,50,216
17/7/2023,Chumphon,18,6,0,0,5,0,0,29
17/7/2023,Ranong,11936,3130,0,0,3524,0,0,18590
17/7/2023,Nong Khai,0,0,0,0,0,0,0,0
17/8/2023,Chiang Rai,15,5,0,0,5,0,0,25
17/9/2023,Kalasin,790,179,0,0,46,0,1790,2805
17/9/2023,Kamphaeng Phet,12,4,0,0,0,0,12031,12047
17/9/2023,Khon Kaen,0,0,0,0,0,0,0,0
17/9/2023,Nakhon Phanom,75,25,0,0,0,0,120,220
17/9/2023,Pathum Thani,366,122,0,0,0,0,170,658
17/9/2023,Phichit,0,0,0,0,0,0,0,0
17/9/2023,Sakon Nakhon,1643,549,0,0,0,0,4257,6449
17/9/2023,Sukhothai,4894,3221,0,0,768,0,14577,23460
17/9/2023,Nong Bua Lamphu,6,2,0,0,0,0,1100,1108
17/9/2023,Uttaradit,90,30,0,0,1,0,126,247
17/9/2023,Ubon Ratchathani,0,0,0,0,0,0,0,0
17/9/2023,Chiang Rai,180,60,0,0,0,0,21,261
17/9/2023,Chiang Mai,7939,3224,0,0,0,0,313,11476
18/10/2023,Chaiyaphum,0,0,0,0,0,0,0,0
18/10/2023,Nakhon Ratchasima,33,11,0,0,270,0,1369,1683
18/10/2023,Nakhon Sawan,120,40,0,0,0,0,819,979
18/11/2023,Nakhon Si Thammarat,655,188,0,0,0,0,2115,2958
18/11/2023,Phatthalung,18,6,0,0,1081,0,0,1105
18/6/2023,Chanthaburi,150,50,0,0,0,0,0,200
18/7/2023,Chumphon,66,22,0,0,6,0,0,94
18/7/2023,Ranong,391,95,0,0,95,0,0,581
18/9/2023,Kalasin,1498,633,0,0,89,5,6072,8297
18/9/2023,Kamphaeng Phet,6,2,0,0,0,0,400,408
18/9/2023,Chaiyaphum,0,0,0,0,0,0,0,0
18/9/2023,Nakhon Ratchasima,3,1,0,0,1,0,1,6
18/9/2023,Phichit,0,0,0,0,0,0,0,0
18/9/2023,Maha Sarakham,3,1,0,0,0,0,28884,28888
18/9/2023,Roi Et,4116,1615,0,0,0,0,9229,14960
18/9/2023,Sakon Nakhon,5984,1994,0,0,0,0,633,8611
18/9/2023,Sukhothai,1100,358,0,0,238,0,1735,3431
18/9/2023,Nong Khai,0,0,0,0,0,0,0,0
18/9/2023,Udon Thani,0,0,0,0,0,0,0,0
18/9/2023,Ubon Ratchathani,0,0,0,0,0,0,0,0
18/9/2023,Chiang Rai,1185,395,0,0,32,1,989,2602
18/9/2023,Chiang Mai,1740,400,0,0,0,0,10,2150
18/9/2023,Phetchabun,0,0,0,0,0,0,0,0
19/10/2023,Nakhon Sawan,0,0,0,0,0,0,0,0
19/10/2023,Phichit,0,0,0,0,0,0,0,0
19/10/2023,Sukhothai,34,16,0,0,0,0,0,50
19/11/2023,Nakhon Si Thammarat,1100,290,0,0,0,0,0,1390
19/11/2023,Songkhla,0,0,0,0,0,0,0,0
19/7/2023,Ranong,13,3,0,0,3,0,0,19
19/7/2023,Satun,0,0,0,0,0,0,0,0
19/7/2023,Chiang Rai,6,2,0,0,1,0,5,14
19/8/2023,Suphan Buri,0,0,0,0,0,0,0,0
19/8/2023,Chiang Rai,12,4,0,0,0,0,4,20
19/9/2023,Kamphaeng Phet,6,2,0,0,0,0,1725,1733
19/9/2023,Phayao,0,0,0,0,0,0,0,0
19/9/2023,Phichit,0,0,0,0,0,0,0,0
19/9/2023,Sukhothai,10529,3587,0,0,77,2,44935,59130
19/9/2023,Nong Khai,0,0,0,0,0,0,0,0
19/9/2023,Ubon Ratchathani,0,0,0,0,0,0,0,0
19/9/2023,Chiang Mai,2009,803,0,0,3,0,0,2815
2/10/2023,Khon Kaen,9,3,0,0,7,0,35813,35832
2/10/2023,Chachoengsao,0,0,0,0,0,0,0,0
2/10/2023,Nakhon Pathom,438,189,0,0,183,0,71,881
2/10/2023,Nakhon Sawan,0,0,0,0,0,0,0,0
2/10/2023,Phichit,0,0,0,0,0,0,0,0
2/10/2023,Maha Sarakham,66,22,0,0,97,0,16027,16212
2/10/2023,Roi Et,1450,765,0,0,0,0,3546,5761
2/10/2023,Saraburi,3,1,0,0,3,0,61,68
2/10/2023,Suphan Buri,21,7,0,0,3397,0,0,3425
2/10/2023,Sukhothai,575,166,0,0,0,0,385,1126
2/10/2023,Ang Thong,9,3,0,0,0,0,72,84
2/11/2023,Chiang Mai,0,0,0,0,0,0,0,0
2/12/2023,Chumphon,15,5,1,0,13,0,0,34
2/12/2023,Trang,0,0,0,0,0,0,0,0
2/12/2023,Narathiwat,6697,1587,0,0,1817,0,0,10101
2/7/2023,Khon Kaen,3,1,0,0,7,0,0,11
2/7/2023,Trang,0,0,0,0,0,0,0,0
2/7/2023,Satun,111,37,0,0,0,0,0,148
2/7/2023,spread,3,1,0,0,3,0,0,7
2/8/2023,Chiang Rai,2607,869,0,0,0,0,0,3476
2/8/2023,Chiang Mai,869,861,0,0,4,0,23,1757
2/9/2023,Chanthaburi,687,229,0,0,25,0,5000,5941
2/9/2023,Trat,600,200,0,0,200,0,15,1015
2/9/2023,Satun,0,0,0,0,0,0,0,0
2/9/2023,Saraburi,3,1,0,0,0,0,500,504
2/9/2023,Chiang Mai,15,5,0,0,3,0,1,24
20/10/2023,Kanchanaburi,5,5,0,0,0,0,15,25
20/10/2023,dry,0,0,0,0,0,0,0,0
20/10/2023,Nakhon Sawan,156,52,0,0,0,0,1414,1622
20/10/2023,Phichit,0,0,0,0,0,0,0,0
20/2/2023,Samut Sakhon,40,16,0,0,7,0,100,163
20/7/2023,Rayong,200,68,0,0,0,0,0,268
20/7/2023,Satun,0,0,0,0,0,0,0,0
20/8/2023,Nakhon Ratchasima,3,1,0,0,1,0,2,7
20/8/2023,Chiang Rai,12,4,0,0,0,0,12,28
20/9/2023,Kalasin,633,493,0,0,25,0,5589,6740
20/9/2023,Kamphaeng Phet,6,2,0,0,0,0,2492,2500
20/9/2023,Nan,0,0,0,0,0,0,0,0
20/9/2023,Pathum Thani,270,90,0,0,90,0,60,510
20/9/2023,Phichit,0,0,0,0,0,0,0,0
20/9/2023,Roi Et,450,128,0,0,0,0,565,1143
20/9/2023,Sukhothai,119,58,0,0,13,0,0,190
20/9/2023,Udon Thani,0,0,0,0,0,0,0,0
20/9/2023,Ubon Ratchathani,0,0,0,0,0,0,0,0
20/9/2023,Chiang Rai,168,56,0,0,0,0,225,449
20/9/2023,Mae Hong Son,0,0,0,0,0,0,0,0
21/10/2023,Kanchanaburi,60,15,0,0,0,0,218,293
21/10/2023,Nakhon Pathom,30,8,0,0,0,0,2,40
21/10/2023,Narathiwat,133,31,0,0,31,0,0,195
21/10/2023,Buriram,45,15,0,0,0,0,1623,1683
21/10/2023,Yala,6,2,0,0,1,0,0,9
21/10/2023,Sukhothai,19,6,0,0,0,0,16,41
21/10/2023,Chiang Rai,150,50,0,0,0,0,20,220
21/10/2023,Chiang Mai,1923,641,0,0,0,0,0,2564
21/11/2023,Narathiwat,8,2,0,0,1,0,0,11
21/7/2023,Chanthaburi,78,26,0,0,0,0,0,104
21/8/2023,Chiang Rai,90,30,0,0,0,0,0,120
21/9/2023,Chanthaburi,21,7,0,0,4,0,0,32
21/9/2023,Chaiyaphum,0,0,0,0,0,0,0,0
21/9/2023,Nakhon Pathom,176,55,0,0,35,0,0,266
21/9/2023,Roi Et,916,233,0,0,0,0,1958,3107
22/10/2023,Nakhon Si Thammarat,278,68,0,0,40,0,0,386
22/10/2023,Narathiwat,6,2,0,0,2,0,0,10
22/10/2023,Lampang,138,46,0,0,0,0,23,207
22/11/2023,Narathiwat,1143,366,0,0,359,0,0,1868
22/11/2023,Yala,9,3,0,0,224,0,17,253
22/7/2023,Rayong,91,26,0,0,0,0,0,117
22/7/2023,Chiang Mai,2854,1854,0,0,0,0,0,4708
22/8/2023,Nakhon Phanom,129,43,0,0,0,0,182,354
22/9/2023,Chachoengsao,0,0,0,0,0,0,0,0
22/9/2023,Nakhon Pathom,279,279,0,0,0,0,0,558
22/9/2023,Phichit,0,0,0,0,0,0,0,0
22/9/2023,Sukhothai,156,73,0,0,0,0,550,779
23/10/2023,Trang,0,0,0,0,0,0,0,0
23/12/2023,Narathiwat,86177,23304,0,0,344,0,0,109825
23/5/2023,Chiang Mai,0,5904,0,0,0,0,25,5929
23/7/2023,Trat,7,2,0,0,3,0,0,12
23/7/2023,Nakhon Pathom,12,4,0,0,40,0,0,56
23/7/2023,Phitsanulok,3,1,0,0,27,0,0,31
23/8/2023,Chiang Mai,2642,907,0,0,0,0,28,3577
23/9/2023,Chanthaburi,9,3,2,1,0,0,0,15
23/9/2023,dry,0,0,0,0,0,0,0,0
23/9/2023,Sukhothai,116,69,0,0,0,0,680,865
24/10/2023,Trang,0,0,0,0,0,0,0,0
24/11/2023,Pattani,675,160,0,0,160,0,0,995
24/12/2023,Narathiwat,99172,25649,6,0,0,0,0,124827
24/12/2023,Pattani,925,260,0,0,319,0,55,1559
24/7/2023,Kalasin,15,5,0,0,0,0,0,20
24/7/2023,Khon Kaen,3,1,0,0,0,0,5,9
24/7/2023,Udon Thani,0,0,0,0,0,0,0,0
24/8/2023,Chiang Rai,3,1,0,0,0,0,0,4
24/9/2023,Kalasin,110,110,0,0,0,0,0,220
24/9/2023,Chiang Mai,6601,2623,0,0,0,0,12,9236
25/1/2023,Nakhon Si Thammarat,0,0,0,0,0,0,0,0
25/10/2023,Kanchanaburi,22,10,0,0,0,0,28,60
25/10/2023,dry,12,4,0,0,0,0,0,16
25/10/2023,Buriram,9,3,0,0,0,0,168,180
25/11/2023,Chumphon,434,174,0,0,104,0,85,797
25/11/2023,Nakhon Si Thammarat,880,310,0,0,0,0,0,1190
25/11/2023,Pattani,1356,379,1,0,2809,0,136,4681
25/11/2023,Phatthalung,0,0,0,0,0,0,0,0
25/11/2023,Songkhla,753,251,1,0,0,0,0,1005
25/11/2023,Surat Thani,6242,1814,0,0,4,0,6800,14860
25/12/2023,Songkhla,3,1,0,0,0,0,0,4
25/12/2023,Satun,0,0,0,0,0,0,0,0
25/6/2023,Chanthaburi,12,4,0,0,0,0,0,16
25/7/2023,Udon Thani,0,0,0,0,0,0,0,0
25/8/2023,Chiang Rai,6,2,0,0,2,0,0,10
25/9/2023,Kalasin,276,187,0,0,0,0,1650,2113
25/9/2023,Chanthaburi,600,150,0,0,0,0,0,750
25/9/2023,Roi Et,1814,275,0,0,0,0,5283,7372
25/9/2023,Si Sa Ket,6,2,0,0,0,0,3781,3789
25/9/2023,Satun,120,40,0,0,0,0,0,160
25/9/2023,Ubon Ratchathani,0,0,0,0,0,0,0,0
25/9/2023,Chiang Mai,8260,3888,0,0,0,0,20,12168
26/1/2023,Surat Thani,0,50,0,0,0,0,30,80
26/10/2023,Kanchanaburi,406,162,0,0,0,0,31,599
26/10/2023,Yala,30,10,0,0,3,0,0,43
26/10/2023,Sa Kaeo,900,300,0,0,0,0,0,1200
26/10/2023,Chiang Mai,5901,2432,0,0,1,0,12,8346
26/11/2023,Nakhon Si Thammarat,1304,405,0,0,0,0,0,1709
26/11/2023,Pattani,21,7,0,0,157,0,0,185
26/11/2023,Songkhla,1263,421,0,0,0,0,0,1684
26/11/2023,Surat Thani,208,60,0,0,0,0,0,268
26/7/2023,Kalasin,735,294,0,0,0,0,2199,3228
26/7/2023,Trat,21,5,0,0,1,0,0,27
26/8/2023,Nan,0,0,0,0,0,0,0,0
26/9/2023,Krabi,3,1,0,0,0,0,0,4
26/9/2023,Kalasin,2353,786,0,0,0,0,0,3139
26/9/2023,Kamphaeng Phet,3,1,0,0,0,0,120,124
26/9/2023,Khon Kaen,6,2,0,0,21,0,9455,9484
26/9/2023,Chachoengsao,0,0,0,0,0,0,0,0
26/9/2023,Chaiyaphum,0,0,0,0,0,0,0,0
26/9/2023,Nakhon Pathom,3476,1171,0,0,38,0,0,4685
26/9/2023,Roi Et,45,17,0,0,0,0,0,62
26/9/2023,Si Sa Ket,0,0,0,0,0,0,0,0
26/9/2023,Satun,0,0,0,0,0,0,0,0
26/9/2023,Samut Sakhon,75,25,0,0,308,0,0,408
26/9/2023,Saraburi,3,1,0,0,0,0,55,59
26/9/2023,Sa Kaeo,900,300,0,0,0,0,0,1200
26/9/2023,Sukhothai,8607,5019,0,0,0,0,39312,52938
26/9/2023,Nong Khai,0,0,0,0,0,0,0,0
26/9/2023,Ang Thong,15,5,0,0,0,0,269,289
26/9/2023,Chiang Mai,11826,3660,0,0,0,0,12,15498
27/10/2023,Nakhon Ratchasima,3,1,0,0,0,0,115,119
27/10/2023,Phayao,120,40,0,0,0,0,70,230
27/10/2023,Yala,6,2,0,0,0,0,2,10
27/10/2023,Chiang Rai,780,260,0,0,8,0,20,1068
27/10/2023,Chiang Mai,1974,775,0,0,7,0,200,2956
27/11/2023,Chumphon,15,5,0,0,0,0,60,80
27/11/2023,Trang,675,225,0,0,0,0,0,900
27/11/2023,Pattani,153,51,0,0,895,0,1104,2203
27/11/2023,Phatthalung,0,0,0,0,0,0,0,0
27/11/2023,Songkhla,0,0,0,0,0,0,0,0
27/11/2023,Surat Thani,181,89,0,0,0,0,0,270
27/7/2023,Nakhon Phanom,1782,594,0,0,0,0,3004,5380
27/9/2023,Kamphaeng Phet,3,1,0,0,0,0,8130,8134
27/9/2023,Chanthaburi,12462,4154,0,0,100,0,1249,17965
27/9/2023,Chachoengsao,0,0,0,0,0,0,0,0
27/9/2023,Chaiyaphum,0,0,0,0,0,0,0,0
27/9/2023,Trang,0,0,0,0,0,0,0,0
27/9/2023,dry,20,14,0,0,0,0,0,34
27/9/2023,Nakhon Nayok,0,0,0,0,0,0,0,0
27/9/2023,Nakhon Pathom,380,131,0,0,40,0,0,551
27/9/2023,Nakhon Ratchasima,18,6,0,0,260,0,22,306
27/9/2023,Pathum Thani,9,3,0,0,0,0,0,12
27/9/2023,Prachin Buri,9,3,0,0,201,0,0,213
27/9/2023,Phichit,0,0,0,0,0,0,0,0
27/9/2023,Yala,1,1,1,1,0,0,0,4
27/9/2023,Lamphun,0,0,0,0,0,0,0,0
27/9/2023,Samut Sakhon,9,3,0,0,20,0,0,32
27/9/2023,Suphan Buri,21,7,0,0,3485,0,0,3513
27/9/2023,Surin,6,2,0,0,0,0,0,8
27/9/2023,Ubon Ratchathani,3,1,0,0,24,0,0,28
27/9/2023,Chiang Mai,21335,6921,0,0,1,0,19,28276
28/10/2023,Nakhon Ratchasima,9,3,0,0,1000,0,341,1353
28/10/2023,Phichit,0,0,0,0,0,0,0,0
28/10/2023,Chiang Mai,7439,4432,0,0,760,0,666,13297
28/11/2023,Chumphon,3,1,1,0,0,0,0,5
28/11/2023,Trang,0,0,0,0,0,0,0,0
28/11/2023,Nakhon Si Thammarat,0,0,0,0,0,0,0,0
28/12/2023,Narathiwat,0,0,0,0,0,0,0,0
28/5/2023,Chiang Mai,0,3627,0,0,0,0,0,3627
28/6/2023,Chiang Mai,3,1,0,0,0,0,0,4
28/7/2023,Sakon Nakhon,8610,2870,0,0,0,0,24211,35691
28/7/2023,Nong Khai,0,0,0,0,0,0,0,0
28/7/2023,Chiang Mai,5888,4888,0,0,0,0,60,10836
28/8/2023,Chiang Mai,5534,1908,0,0,0,0,0,7442
28/9/2023,Kalasin,4808,4704,0,0,355,0,20675,30542
28/9/2023,Kamphaeng Phet,6,2,0,0,1,0,5000,5009
28/9/2023,Khon Kaen,3,1,0,0,0,0,208,212
28/9/2023,Chanthaburi,1470,490,1,0,11,0,0,1972
28/9/2023,Chachoengsao,36,12,0,0,500,0,0,548
28/9/2023,Chaiyaphum,0,0,0,0,0,0,0,0
28/9/2023,Trat,200,71,0,0,0,0,0,271
28/9/2023,dry,0,0,0,0,0,0,0,0
28/9/2023,Nakhon Nayok,0,0,0,0,0,0,0,0
28/9/2023,Nakhon Pathom,639,222,0,0,169,0,5,1035
28/9/2023,Nakhon Ratchasima,21,7,0,0,1315,0,0,1343
28/9/2023,Prachin Buri,100,48,0,0,135,0,370,653
28/9/2023,Phichit,0,0,0,0,0,0,0,0
28/9/2023,Maha Sarakham,63,21,0,0,0,0,1849,1933
28/9/2023,Mukdahan,9,3,0,0,0,0,14,26
28/9/2023,Roi Et,58,20,0,0,0,0,0,78
28/9/2023,Lop Buri,0,0,0,0,0,0,0,0
28/9/2023,Lampang,2892,964,0,0,205,0,440,4501
28/9/2023,Lamphun,0,0,0,0,0,0,0,0
28/9/2023,Sa Kaeo,530,210,0,0,10,0,0,750
28/9/2023,Sukhothai,6031,2294,0,0,0,0,22932,31257
28/9/2023,Nong Bua Lamphu,3,1,0,0,0,0,700,704
28/9/2023,Uttaradit,3600,1200,0,0,0,0,2000,6800
28/9/2023,Uthai Thani,0,0,0,0,0,0,0,0
28/9/2023,Ubon Ratchathani,0,0,0,0,0,0,0,0
28/9/2023,Chiang Rai,552,184,0,0,184,0,0,920
28/9/2023,Chiang Mai,6608,2202,0,0,4,0,90,8904
28/9/2023,Phetchabun,15,5,0,0,31,0,19,70
28/9/2023,at all,4536,1227,0,0,1145,0,1185,8093
29/10/2023,Kanchanaburi,6,2,0,0,7,0,120,135
29/10/2023,Kamphaeng Phet,6,2,0,0,6,0,655,669
29/10/2023,dry,3,1,0,0,0,0,0,4
29/10/2023,Nakhon Pathom,6,2,0,0,0,0,0,8
29/10/2023,Chiang Mai,1196,470,0,0,2,0,512,2180
29/11/2023,Trang,0,0,0,0,0,0,0,0
29/11/2023,Nakhon Si Thammarat,410,85,0,0,0,0,0,495
29/11/2023,Pattani,213,71,1,0,7582,0,0,7867
29/11/2023,Phatthalung,0,0,0,0,0,0,0,0
29/6/2023,Udon Thani,0,0,0,0,0,0,0,0
29/7/2023,Nakhon Phanom,4656,1552,0,0,0,0,6364,12572
29/7/2023,Nan,0,0,0,0,0,0,0,0
29/7/2023,Ubon Ratchathani,0,0,0,0,0,0,0,0
29/7/2023,Chiang Mai,7901,5711,0,0,0,0,0,13612
29/8/2023,Kalasin,2500,905,0,0,0,0,0,3405
29/8/2023,Phangnga,60,20,0,0,427,0,0,507
29/9/2023,Kamphaeng Phet,3,1,0,0,0,0,4,8
29/9/2023,Chanthaburi,73,6,0,0,0,0,0,79
29/9/2023,dry,0,0,0,0,0,0,0,0
29/9/2023,Nakhon Nayok,0,0,0,0,0,0,0,0
29/9/2023,Nakhon Pathom,150,50,0,0,0,0,0,200
29/9/2023,Prachin Buri,165,55,0,0,32,0,0,252
29/9/2023,Phichit,0,0,0,0,0,0,0,0
29/9/2023,Yala,1050,350,0,0,0,0,0,1400
29/9/2023,Lampang,16950,5650,0,0,5492,1,2416,30509
29/9/2023,Lamphun,0,0,0,0,0,0,0,0
29/9/2023,Sa Kaeo,200,1,0,0,0,0,0,201
29/9/2023,Udon Thani,0,0,0,0,0,0,0,0
29/9/2023,Chiang Mai,1293,366,0,0,75,0,70,1804
29/9/2023,Phetchabun,75,25,0,0,30,0,2552,2682
29/9/2023,at all,61,25,0,0,59,0,29,174
29/9/2023,spread,1905,635,0,0,70,0,14,2624
3/10/2023,Kalasin,212,133,0,0,0,0,358,703
3/10/2023,Khon Kaen,3,1,0,0,0,0,1656,1660
3/10/2023,Chanthaburi,9,3,0,0,3,0,5,20
3/10/2023,dry,0,0,0,0,0,0,0,0
3/10/2023,Nakhon Pathom,1081,411,0,0,100,0,70,1662
3/10/2023,Maha Sarakham,3,1,0,0,0,0,1429,1433
3/10/2023,Si Sa Ket,0,0,0,0,0,0,0,0
3/10/2023,Sakon Nakhon,324,108,0,0,0,0,2195,2627
3/10/2023,Samut Prakan,6285,2095,0,0,0,0,0,8380
3/10/2023,Sa Kaeo,396,132,0,0,5,0,1428,1961
3/10/2023,Sukhothai,1049,468,0,0,0,0,2512,4029
3/10/2023,Ubon Ratchathani,0,0,0,0,0,0,0,0
3/10/2023,Ang Thong,18,6,0,0,0,0,2570,2594
3/11/2023,Sa Kaeo,48,16,0,0,0,0,116,180
3/12/2023,Trang,0,0,0,0,0,0,0,0
3/12/2023,Nakhon Si Thammarat,600,155,0,0,0,0,0,755
3/12/2023,Narathiwat,2175,465,0,0,425,0,0,3065
3/12/2023,Yala,3,1,0,1,81,0,0,86
3/7/2023,Kalasin,1200,500,0,0,6,0,1589,3295
3/8/2023,Kalasin,254,55,0,0,0,0,0,309
3/8/2023,Nakhon Phanom,5508,1836,0,0,0,0,16053,23397
3/9/2023,Trang,0,0,0,0,0,0,0,0
3/9/2023,Nakhon Nayok,0,0,0,0,0,0,0,0
3/9/2023,Mukdahan,497,41,0,0,0,0,1162,1700
3/9/2023,Chiang Mai,100,40,0,0,0,0,120,260
30/10/2023,Kamphaeng Phet,12,4,0,0,150,0,1481,1647
30/10/2023,Nakhon Ratchasima,27,9,0,0,1350,0,84,1470
30/10/2023,Phichit,6,2,0,0,0,0,339,347
30/10/2023,Chiang Rai,615,205,0,0,10,0,254,1084
30/10/2023,Chiang Mai,4979,1876,0,0,35,0,435,7325
30/10/2023,Mae Hong Son,0,0,0,0,0,0,0,0
30/11/2023,Nakhon Si Thammarat,450,160,0,0,0,0,30,640
30/11/2023,Pattani,30,10,0,0,1148,0,0,1188
30/11/2023,Songkhla,0,0,0,0,0,0,0,0
30/4/2023,Chonburi,3,14,0,0,1,0,59,77
30/4/2023,Nakhon Ratchasima,3,1,0,0,0,0,0,4
30/5/2023,Nakhon Ratchasima,3,1,0,0,9,0,0,13
30/6/2023,Satun,0,0,0,0,0,0,0,0
30/7/2023,Kalasin,10625,2730,0,0,12,0,160,13527
30/7/2023,Nakhon Phanom,210,70,0,0,0,0,1020,1300
30/7/2023,Sakon Nakhon,1479,493,0,0,0,0,3990,5962
30/8/2023,Nan,0,0,0,0,0,0,0,0
30/9/2023,dry,0,0,0,0,0,0,0,0
30/9/2023,Nakhon Nayok,0,0,0,0,0,0,0,0
30/9/2023,Nan,9,3,0,0,2,0,0,14
30/9/2023,Phichit,0,0,0,0,0,0,0,0
30/9/2023,Lampang,120,40,0,0,40,0,53,253
30/9/2023,Sakon Nakhon,336,112,0,0,0,0,973,1421
30/9/2023,Sukhothai,9437,5282,1,0,1749,0,31876,48345
30/9/2023,Nong Khai,0,0,0,0,0,0,0,0
30/9/2023,Nong Bua Lamphu,6,2,0,0,0,0,1134,1142
30/9/2023,Chiang Mai,1550,500,0,0,0,0,5,2055
30/9/2023,spread,10743,3581,0,0,500,0,2695,17519
31/10/2023,Kamphaeng Phet,3,1,0,0,0,0,0,4
31/10/2023,Nakhon Pathom,265,103,0,0,3,0,0,371
31/10/2023,Chiang Mai,4250,1200,0,0,6,0,573,6029
31/7/2023,Nakhon Phanom,2577,859,0,0,0,0,4460,7896
31/7/2023,Chiang Mai,8892,8892,0,0,0,0,20,17804
31/8/2023,Satun,0,0,0,0,0,0,0,0
31/8/2023,Surin,3,1,0,0,0,0,0,4
4/10/2023,Kamphaeng Phet,6,2,0,0,0,0,81,89
4/10/2023,Chanthaburi,100,50,0,0,50,0,90,290
4/10/2023,Chachoengsao,0,0,0,0,0,0,0,0
4/10/2023,Chaiyaphum,0,0,0,0,0,0,0,0
4/10/2023,dry,0,0,0,0,0,0,0,0
4/10/2023,Nakhon Pathom,34,22,0,0,2,0,113,171
4/10/2023,Nakhon Sawan,78,26,0,0,13,0,3,120
4/10/2023,Phichit,0,0,0,0,0,0,0,0
4/10/2023,Saraburi,12,4,0,0,51,0,5110,5177
4/10/2023,Uttaradit,633,211,0,0,0,0,2532,3376
4/10/2023,Ang Thong,3,1,0,0,0,0,3,7
4/11/2023,Krabi,0,0,0,0,0,0,0,0
4/11/2023,Satun,100,30,0,0,0,0,36,166
4/7/2023,Kalasin,250,95,0,0,0,0,1305,1650
4/8/2023,Nakhon Phanom,1458,486,0,0,0,0,1511,3455
4/8/2023,Nan,0,0,0,0,0,0,0,0
4/8/2023,Chiang Mai,2801,2801,0,0,0,0,0,5602
4/9/2023,Kalasin,25323,7942,0,0,0,0,0,33265
4/9/2023,Chumphon,6,2,0,0,0,0,5,13
4/9/2023,Nakhon Ratchasima,3,1,0,0,1,0,0,5
4/9/2023,Nan,0,0,0,0,0,0,0,0
4/9/2023,Mukdahan,312,28,0,0,0,0,1067,1407
4/9/2023,Chiang Mai,628,246,0,0,0,0,0,874
5/10/2023,Kanchanaburi,5042,1322,0,0,176,0,1093,7633
5/10/2023,Kalasin,944,402,0,0,0,0,16904,18250
5/10/2023,Kamphaeng Phet,6,2,0,0,0,0,1806,1814
5/10/2023,Khon Kaen,3,1,0,0,0,0,990,994
5/10/2023,Chachoengsao,0,0,0,0,0,0,0,0
5/10/2023,Chaiyaphum,0,0,0,0,0,0,0,0
5/10/2023,Nakhon Nayok,0,0,0,0,0,0,0,0
5/10/2023,Prachin Buri,3,1,0,0,8,0,143,155
5/10/2023,Ayutthaya,0,0,0,0,0,0,0,0
5/10/2023,Phichit,0,0,0,0,0,0,0,0
5/10/2023,Roi Et,3,1,0,0,0,0,1800,1804
5/10/2023,Lop Buri,12,4,0,0,0,0,2997,3013
5/10/2023,Saraburi,6,2,0,0,0,0,376,384
5/10/2023,Suphan Buri,3,1,0,0,4,0,0,8
5/10/2023,Sukhothai,2190,743,0,0,0,0,12761,15694
5/10/2023,Uthai Thani,0,0,0,0,0,0,0,0
5/10/2023,Ubon Ratchathani,0,0,0,0,0,0,0,0
5/10/2023,Mae Hong Son,0,0,0,0,0,0,0,0
5/7/2023,Kalasin,258,86,0,0,0,0,428,772
5/8/2023,Nan,3,1,0,0,1,0,0,5
5/8/2023,Sakon Nakhon,1797,599,0,0,0,0,6899,9295
5/8/2023,Nong Khai,0,0,0,0,0,0,0,0
5/8/2023,Chiang Mai,1088,438,0,0,0,0,0,1526
5/9/2023,Kalasin,12627,3651,0,0,6,0,15930,32214
5/9/2023,Nan,0,0,0,0,0,0,0,0
5/9/2023,Mukdahan,73,15,1,0,0,0,115,204
5/9/2023,Ranong,200,40,0,0,40,0,0,280
5/9/2023,Roi Et,4508,1857,1,0,9,0,22180,28555
5/9/2023,Saraburi,0,0,0,0,0,0,0,0
5/9/2023,spread,3,1,0,0,0,0,0,4
6/10/2023,Kanchanaburi,250,80,0,0,0,0,0,330
6/10/2023,Kalasin,15,6,0,0,0,0,34,55
6/10/2023,Kamphaeng Phet,3,1,0,0,100,0,3072,3176
6/10/2023,Chachoengsao,0,0,0,0,0,0,0,0
6/10/2023,dry,30,6,0,0,0,0,0,36
6/10/2023,Nakhon Nayok,0,0,0,0,0,0,0,0
6/10/2023,Nakhon Pathom,6,3,0,0,0,0,7,16
6/10/2023,Prachin Buri,0,0,0,0,0,0,0,0
6/10/2023,Phichit,0,0,0,0,0,0,0,0
6/10/2023,Lampang,45,15,0,0,0,0,0,60
6/10/2023,Sukhothai,1704,685,0,0,0,0,2890,5279
6/10/2023,Uttaradit,2016,672,0,0,171,0,1251,4110
6/10/2023,Uthai Thani,0,0,0,0,0,0,0,0
6/10/2023,Ubon Ratchathani,0,0,0,0,0,0,0,0
6/10/2023,Chiang Mai,2000,548,0,0,0,0,0,2548
6/10/2023,Phetchabun,0,0,0,0,0,0,0,0
6/10/2023,at all,3896,1161,0,0,929,0,58,6044
6/11/2023,Kamphaeng Phet,3,1,0,0,0,0,665,669
6/11/2023,Chiang Mai,140,70,0,0,4,0,0,214
6/12/2023,Chumphon,2,2,0,0,1,0,0,5
6/6/2023,Chanthaburi,60,20,0,0,0,0,0,80
6/6/2023,Phitsanulok,131,36,0,0,0,0,577,744
6/8/2023,Nakhon Phanom,219,73,0,0,0,0,267,559
6/8/2023,Nan,0,0,0,0,0,0,0,0
6/8/2023,Phayao,0,0,0,0,0,0,0,0
6/8/2023,Chiang Rai,28407,9469,0,0,0,0,0,37876
6/9/2023,Kalasin,7415,3079,1,0,0,0,7301,17796
6/9/2023,Khon Kaen,3,1,0,0,3,0,55,62
6/9/2023,Nakhon Ratchasima,3,1,0,0,15,0,0,19
6/9/2023,Mukdahan,114,7,0,0,0,0,557,678
6/9/2023,Uttaradit,24,8,0,0,0,0,8,40
6/9/2023,Chiang Mai,241,65,0,0,10,0,50,366
7/10/2023,Chanthaburi,1,1,0,0,0,0,1,3
7/10/2023,Chachoengsao,0,0,0,0,0,0,0,0
7/10/2023,Nan,3,1,0,0,7,0,0,11
7/10/2023,Ayutthaya,0,0,0,0,0,0,0,0
7/10/2023,Ang Thong,3,1,0,0,0,0,15,19
7/10/2023,Chiang Mai,700,150,0,0,50,0,0,900
7/10/2023,Phetchabun,3,1,0,0,258,0,1185,1447
7/10/2023,at all,450,150,0,0,150,0,0,750
7/10/2023,spread,474,158,0,0,0,0,0,632
7/11/2023,Nakhon Pathom,1,1,0,0,0,0,0,2
7/11/2023,Chiang Mai,100,40,0,0,0,0,0,140
7/8/2023,Nan,0,0,0,0,0,0,0,0
7/8/2023,Chiang Mai,3286,1207,0,0,0,0,0,4493
7/9/2023,Kalasin,3920,1619,0,0,200,0,14185,19924
7/9/2023,Nan,27,9,0,0,10,0,7,53
8/10/2023,Khon Kaen,1565,431,0,0,466,20,2125,4607
8/10/2023,Nakhon Nayok,0,0,0,0,0,0,0,0
8/10/2023,Buriram,234,78,0,0,0,0,8185,8497
8/10/2023,Phichit,0,0,0,0,0,0,0,0
8/10/2023,Maha Sarakham,3,1,0,0,0,0,3650,3654
8/10/2023,Yala,1650,550,0,0,0,0,0,2200
8/10/2023,Lop Buri,3,1,0,0,0,0,2079,2083
8/10/2023,Lampang,2286,762,0,0,0,0,5,3053
8/10/2023,Suphan Buri,9,3,0,0,4004,0,0,4016
8/10/2023,Surin,3,1,0,0,5,0,0,9
8/10/2023,Nong Bua Lamphu,9,3,0,0,43,0,1010,1065
8/10/2023,Uttaradit,168,56,0,0,0,0,32,256
8/10/2023,Ang Thong,6,2,0,0,0,0,49,57
8/10/2023,Chiang Rai,360,120,0,0,0,0,74,554
8/10/2023,Chiang Mai,1400,700,0,0,0,0,0,2100
8/10/2023,Phetchabun,186,62,0,0,940,0,5150,6338
8/10/2023,spread,3,1,0,0,0,0,0,4
8/11/2023,Surin,3,1,0,0,10,0,0,14
8/6/2023,Phitsanulok,45,15,0,0,15,0,0,75
8/7/2023,Phangnga,3,1,0,0,10,0,0,14
8/8/2023,Nan,3,1,0,0,24,0,0,28
8/8/2023,Nong Khai,0,0,0,0,0,0,0,0
8/8/2023,Chiang Mai,200,50,0,0,0,0,0,250
8/9/2023,Kalasin,873,291,0,0,0,0,219,1383
8/9/2023,Khon Kaen,3,1,0,0,0,0,713,717
8/9/2023,Nan,0,0,0,0,0,0,0,0
8/9/2023,Phichit,0,0,0,0,0,0,0,0
8/9/2023,Chiang Mai,1000,200,0,0,0,0,0,1200
8/9/2023,Mae Hong Son,15,5,0,0,0,0,0,20
9/10/2023,Kamphaeng Phet,3,1,0,0,24,0,3014,3042
9/10/2023,Khon Kaen,675,225,0,0,39,0,1359,2298
9/10/2023,Chachoengsao,0,0,0,0,0,0,0,0
9/10/2023,Nakhon Nayok,0,0,0,0,0,0,0,0
9/10/2023,Nakhon Ratchasima,60,20,0,0,840,0,921,1841
9/10/2023,Phichit,0,0,0,0,0,0,0,0
9/10/2023,Maha Sarakham,12,4,0,0,99,0,16579,16694
9/10/2023,Lampang,523,170,0,0,0,0,20,713
9/10/2023,Sa Kaeo,450,150,0,0,0,0,300,900
9/10/2023,Surin,6,2,0,0,0,0,0,8
9/10/2023,Sukhothai,15,4,0,0,0,0,62,81
9/10/2023,Nong Bua Lamphu,9,3,0,0,252,0,20339,20603
9/10/2023,Uttaradit,9513,3171,0,0,1446,0,8516,22646
9/10/2023,Ubon Ratchathani,0,0,0,0,0,0,0,0
9/10/2023,Chiang Rai,3783,1261,0,0,0,0,10,5054
9/10/2023,Chiang Mai,1143,346,0,0,0,0,255,1744
9/10/2023,at all,208,51,0,0,53,3,100,415
9/10/2023,spread,294,98,0,0,18,0,84,494
9/11/2023,Phetchaburi,1100,270,0,0,0,0,25,1395
9/5/2023,Nakhon Ratchasima,3,1,0,0,0,0,0,4
9/8/2023,Nan,0,0,0,0,0,0,0,0
9/8/2023,Udon Thani,0,0,0,0,0,0,0,0
9/9/2023,Kalasin,1564,727,0,0,6,0,9081,11378
9/9/2023,Mukdahan,166,13,0,0,0,0,443,622
9/9/2023,Roi Et,231,71,0,0,0,0,3431,3733
9/9/2023,Lampang,105,35,0,0,0,0,0,140
9/9/2023,Chiang Rai,300,100,0,0,0,0,0,400
9/9/2023,Chiang Mai,28765,9642,0,0,0,0,800,39207
